****************
**             *
** ***** ** ** *
** *E     * ** *
** ****** * ****
**    *     *
** * ****** *
 * * *S     *
 * * ****** *
 *          *
 ************
