****************
**             *
** ***** ** ** *
** *      * ** *
** * ** * * ****
**E   *   *S*
**** ****** *
   * *    * *
   * ****** *
   *        *
   **********
