*************
**          *
** **** *** *
** **** *** *
** **** *** *
**E   *    S*
*************
