****************
**             *
** ***** ** ** *
** *E     * ** *
** ******** ****
**    *     * **
** * ****** * **
** * *S     * **
** * ****** * **
** *          **
****************
