*************
**          *
** ***** ** *
** *      * *
** * ** * * *
**E   *    S*
*************
