*************
**          *
** ***** ** *
** *      * *
** * **** * *
**E   * *  S*
*************
