*************
**          *
** **** *** *
** **   *** *
** ** ***** *
**E *      S*
*************
