*************
**         S*
** **** ** **
** **E     **
** *******  *
**          *
*************
