*************
**          *
** **** *** *
** **** *** *
** **** *** *
**E       *S*
*************
