*************
**          *
** ***** ** *
** *      * *
** * ** * * *
**E   *   *S*
*************
