*************
**          *
** **** *** *
** **     * *
** ** ***** *
**E *      S*
*************
