*************
**          *
** ***** ** *
** **E    * *
** ** ** ** *
**         S*
*************
